25 20

############################################
#...........#..............#...............#
#...........#..............#.....#.........#
#...........#...#..........#.....#.........#
#...........#...#..........#.....#.........#
#...........#...#..........#.....#.........#
#...........#...#..........#.....#.........#
#...........#...#..........#.....#.........#
#...........#...#..........#.....#.........#
#...........#...#..........#.....#.........#
#...........#...#..........#.....#.........#
#...........#...#..........#.....#.........#
#...............#................#.........#
############################################