34 14
####d#############################
#...@.......#ttt.....ttt#........#
#...........#...........#.....#..#
#..........g#...#.......#.....#..#
#...........#..k#.......#.....#..#
#...........#...#.......#.....#..#
#pp.pp.pp.pp#...#.......#.....#..#
#s....s....s#...#.......#.....#..#
#...........#...#.......#.....#..#
#...........#...#.......#.....#..#
#...........#...#.......#.....#..#
#...........#...#.......#.....#..d
#...............#.............#..#
##################################