34 14
####d#############################
#...@......a#ttt..k..ttt#........#
#...........#...........#.....#..#
#..........g#...#.......#...u.#..#
#...........#...#.......#.....#..#
#...........#...#.......#..u..#..#
#pp.pp.pp.pp#...#.......#.....#..#
#s....s....s#...#..b....#.....#..#
#...........#...#.......#...u.#..#
#...........#...#.......#.....#..#
#...........#...#.b.....Z.....#..#
#...........#...#.......#.....#..#
#...............#.............#..#
##################################