25 14
####d####################
#...@......a#ttt..k..ttt#
#...........#...........#
#..........g#...#.......#
#....5......#...#.u.....#
#...........#...#.......#
#pp.pp.pp.pp#...#..u....#
#s....s....s#...#..b....#
#...........#...#.......#
#...........#...#....u..#
#...........#...#.......Z
#...........#...#.b.....#
#...............#.......#
#########################